10:10
0,0#0000000:0|
1,0#1011000:0|
2,0#0100000:0|
3,0#0011000:0|
4,0#1000000:0|
5,0#0100000:0|
6,0#0000000:0|
7,0#1011000:0|
8,0#1100000:0|
9,0#1011000:0|
0,1#1010000:0|
1,1#1000001:0|
2,1#1001000:0|
3,1#1000000:0|
4,1#0000100:0|
5,1#0000000:0|
6,1#0000000:0|
7,1#0110101:0|
8,1#1000000:0|
9,1#1000000:0|
0,2#1000011:0|
1,2#1000000:0|
2,2#1100000:0|
3,2#1000000:0|
4,2#1001000:0|
5,2#0101000:0|
6,2#0000000:0|
7,2#1000000:0|
8,2#0100000:0|
9,2#0100000:0|
0,3#1100110:0|
1,3#0100000:0|
2,3#1100000:0|
3,3#0000000:0|
4,3#1000000:0|
5,3#1000000:0|
6,3#0000100:0|
7,3#0000000:0|
8,3#1000000:0|
9,3#1000000:0|
0,4#1100000:0|
1,4#1000000:0|
2,4#0000000:0|
3,4#0100000:0|
4,4#0000000:0|
5,4#0000000:0|
6,4#0100110:0|
7,4#0100000:0|
8,4#0100000:0|
9,4#0010000:0|
0,5#0010000:0|
1,5#0000000:0|
2,5#0000000:0|
3,5#0000000:0|
4,5#0000000:0|
5,5#0000000:0|
6,5#0000000:0|
7,5#0000000:0|
8,5#0000000:0|
9,5#0000000:0|
0,6#1100000:0|
1,6#0010000:0|
2,6#0100000:0|
3,6#0100000:0|
4,6#0100110:0|
5,6#0000000:0|
6,6#0000000:0|
7,6#0110000:0|
8,6#0000000:0|
9,6#1000000:0|
0,7#1100110:0|
1,7#1000000:0|
2,7#1000000:0|
3,7#0000000:0|
4,7#0000100:0|
5,7#1000000:0|
6,7#1000000:0|
7,7#0000000:0|
8,7#1100000:0|
9,7#0100000:0|
0,8#1000010:0|
1,8#0100000:0|
2,8#0100000:0|
3,8#1000000:0|
4,8#0000000:0|
5,8#0101000:0|
6,8#1001000:0|
7,8#1000000:0|
8,8#1100000:0|
9,8#1000000:0|
0,9#1010000:0|
1,9#1000000:0|
2,9#1000000:0|
3,9#0110101:0|
4,9#0000000:0|
5,9#1000000:0|
6,9#0000100:0|
7,9#1000000:0|
8,9#1001000:0|
9,9#1000001:0|
